13 13
       #####
 #######   ##
## # W## .. #
#    .      #
#  .  ###   #
### #####.###
# .  ### ==#
# . . . ===#
#    ###===#
# .. # #===#
#  ### #####
####
