16 17
  ####
  #  ###########
  #    .   . . #
  # .# . #  .  #
  #  . .  #    #
### .# #  #### #
#S#. . .  ##   #
#    . #.#   # #
#   .    . . . #
#####  #########
  #      #
  #      #
  #======#
  #======#
  #======#
  ########
