12 12
######  ###
#==  # ##S##
#==  ###   #
#==     .. #
#==  # # . #
#==### # . #
#### . #.  #
   #  .# . #
   # .  .  #
   #  ##   #
   #########
