17 15
          #######
          #  ===#
      #####  ===#
      #      = =#
      #  ##  ===#
      ## ##  ===#
     ### ########
     # ... ##
 #####  . . #####
##   #. .   #   #
#E .  .    .  . #
###### .. . #####
     #      #
     ########
