14 12
    #####
    #   #
    #.  #
  ###  .##
  #  .   #
### # ## #####
#   # ## # ==#
#    .      =#
##### ###N  =#
    #     ####
    #######
