15 12
      #####
      #   #####
      # #.##  #
      #     . #
####### ###   #
#==  ##  .  ###
#==       . ##
#==  ##.  . W#
#==  ##  .. ##
#######      #
     #########
      
