14 12
    #####
    #   #
    #   #
  ###   ##
  #      #
###      #####
#    .   #   #
#           =#
##### ###    #
    #    W####
    #######
