15 11
      ########
      #     W#
      # .#  ##
      #  .  #
      ##. . #
#######   # ###
#===  # . .   #
#==    .  .  ##
#===  ########
#######
