14 11
    ########
    ##     ###
###### .  .  #
#==  #.####  #
#==    W ##  #
#==  # #    ##
###### ##    #
  # .  .   . #
  #    #     #
  ############
